1,1,1,1,1,1,1,1,1,1,1,1,1,1,1,1,1,1,1,1,1,37,1,1,1,1,1,1,1,1,1,1,1,1,1,1,1,1,1,1,1,1,1,1,1,1,1,1,1,1,1,1,1,1,1,1,1,1,1,1
1,1,1,1,1,1,1,1,1,1,1,1,1,1,1,1,1,1,1,1,1,1,37,37,1,1,1,1,1,1,1,1,1,1,1,1,1,1,1,1,1,1,1,1,1,1,1,1,1,1,1,1,1,1,1,1,1,1,1,1
1,1,1,1,1,1,1,1,1,1,1,1,1,1,1,1,1,1,1,1,1,1,1,1,37,37,1,1,1,1,1,1,1,1,1,1,1,1,1,1,1,1,1,1,1,1,1,1,1,1,1,1,1,1,1,1,1,1,1,1
1,1,1,1,1,1,1,1,1,37,37,37,37,37,37,37,37,37,1,1,1,1,1,1,1,37,1,1,1,1,1,1,1,1,1,1,1,1,1,1,1,1,1,1,1,1,1,1,1,1,1,1,1,1,1,1,1,1,1,1
1,1,1,1,1,1,1,1,37,37,1,1,1,1,1,1,1,1,37,37,37,37,1,1,1,1,1,1,1,1,1,1,1,1,1,1,1,1,1,1,1,1,1,1,1,1,1,1,1,1,1,1,1,1,1,1,1,1,1,1
1,1,1,1,1,1,1,37,1,1,1,1,1,1,1,1,1,1,1,1,1,1,1,1,1,1,37,37,1,1,1,1,37,37,1,1,1,1,1,1,1,1,37,37,37,37,37,1,1,1,1,1,1,1,1,1,1,1,1,1
1,1,1,1,1,1,1,37,37,1,1,1,1,1,1,1,1,37,37,1,1,37,37,1,1,1,37,1,1,1,1,1,1,37,1,1,1,1,1,1,1,1,1,1,1,1,1,1,1,1,1,1,1,1,1,1,1,1,1,1
1,1,1,1,1,37,37,1,1,1,1,1,1,1,1,1,1,37,1,37,37,1,1,1,37,37,1,1,1,37,37,37,37,37,37,37,37,37,1,1,1,1,1,1,1,1,1,37,37,37,1,37,1,1,1,1,1,1,1,1
1,1,1,1,1,37,1,1,1,1,1,1,37,37,1,1,1,37,1,1,1,1,37,37,1,1,1,37,37,1,1,1,1,37,1,37,37,37,37,1,1,1,1,1,1,1,37,37,1,1,37,37,37,1,1,1,1,1,1,1
1,1,1,1,37,37,1,1,1,1,1,1,1,1,37,1,1,37,1,1,37,1,1,1,1,1,1,1,1,1,1,1,1,37,37,1,1,1,37,1,1,1,1,37,1,1,37,1,1,1,1,1,37,37,1,1,1,1,1,1
1,1,1,1,37,37,1,1,1,1,1,1,1,1,37,37,37,1,37,37,1,1,1,1,1,1,1,1,1,1,1,1,37,37,37,1,1,1,1,37,37,37,37,1,37,37,37,1,1,1,1,1,1,37,1,1,1,1,1,1
1,1,1,1,1,37,1,1,1,1,1,1,1,1,1,1,37,1,37,37,1,1,1,1,1,1,1,1,1,1,1,1,1,37,1,1,1,1,37,37,37,1,1,1,1,37,37,37,1,1,1,1,1,1,37,1,1,1,1,1
1,1,1,1,1,1,1,1,1,37,37,37,1,1,1,1,37,37,37,37,1,1,1,1,1,37,37,1,1,1,1,1,1,37,1,1,1,1,37,1,37,1,1,1,1,1,1,37,1,1,1,1,1,1,37,1,1,1,1,1
1,1,1,1,1,1,1,1,1,1,1,37,37,1,1,1,1,1,37,37,1,37,1,1,37,37,1,1,1,1,1,1,1,37,1,1,1,1,1,1,37,1,1,1,1,1,1,37,1,1,1,1,1,1,37,1,1,1,1,1
1,1,1,1,1,1,1,1,1,1,1,1,37,1,1,1,1,1,37,37,1,37,1,1,37,1,1,1,1,37,37,1,1,1,1,1,1,1,1,1,37,1,1,1,1,1,1,1,37,1,1,1,1,1,37,1,1,1,1,1
1,1,1,1,1,1,1,1,1,1,1,1,37,1,1,1,1,37,37,37,1,37,1,1,1,37,37,37,1,1,1,37,1,1,1,1,1,1,1,1,37,1,1,1,1,1,37,1,1,37,1,1,1,1,37,1,1,1,1,1
1,1,1,1,1,1,1,1,1,1,1,1,1,1,1,1,1,37,1,37,1,37,1,1,1,1,1,1,37,37,37,37,37,37,37,37,37,37,37,37,1,1,1,1,37,1,37,1,1,37,37,1,37,37,37,1,1,1,1,1
1,1,1,1,1,1,1,1,1,1,1,1,1,1,37,1,1,1,1,37,1,37,1,1,1,37,37,1,1,1,1,1,1,37,37,1,1,1,1,1,1,1,1,1,1,37,37,37,37,37,37,37,37,37,1,1,1,1,1,1
1,1,1,1,1,1,1,1,1,1,1,1,1,37,1,1,1,1,1,37,1,37,1,1,1,1,1,37,1,37,37,37,37,37,37,1,1,1,1,1,1,1,1,1,1,1,37,1,1,1,37,1,1,1,1,1,1,1,1,1
1,1,1,1,1,1,1,1,1,1,1,37,37,37,1,1,1,1,1,37,1,37,1,1,1,1,1,37,37,37,37,37,37,1,1,1,1,1,1,1,37,1,1,1,1,1,37,1,1,37,37,1,1,1,1,1,1,1,1,1
1,1,1,1,1,37,37,37,37,37,37,37,1,37,37,37,37,37,37,37,37,37,37,37,37,37,37,37,37,37,37,37,1,1,1,1,1,1,1,1,37,1,1,1,1,37,1,1,1,1,1,37,1,1,1,1,1,1,1,1
1,1,1,1,1,37,37,1,1,1,37,1,1,37,1,37,37,1,37,37,37,37,37,1,1,1,1,1,1,1,1,1,1,1,1,1,1,1,1,37,1,1,1,1,37,1,1,1,1,1,37,37,1,1,1,1,1,1,1,1
1,1,1,1,1,1,1,37,37,37,37,37,37,37,37,1,1,1,1,1,1,37,1,37,37,1,1,1,1,1,1,1,1,1,1,1,1,37,37,37,1,1,1,37,1,1,1,1,1,37,37,1,1,1,1,1,1,1,1,1
1,1,1,1,1,1,1,1,1,1,37,37,37,37,37,1,1,1,1,1,1,1,37,37,1,37,37,37,37,37,37,37,37,37,37,37,37,37,37,37,37,37,37,37,37,37,37,37,37,37,1,1,1,1,1,1,1,1,1,1
1,1,1,1,1,1,1,1,1,1,1,37,37,37,1,1,1,1,1,1,1,1,1,37,37,1,1,37,37,37,37,37,37,37,1,37,37,37,37,37,37,37,1,1,1,1,37,37,37,1,1,1,1,1,1,1,1,1,1,1
1,1,1,1,1,1,1,1,1,1,1,1,1,1,37,37,37,1,1,1,37,37,37,37,1,37,1,1,1,1,1,1,1,1,1,1,1,1,1,1,1,1,1,1,1,1,1,1,1,1,1,1,1,1,1,1,1,1,1,1
1,1,1,1,1,1,1,1,37,37,37,1,1,1,1,1,1,37,37,37,1,1,1,1,1,37,1,1,1,1,1,1,1,1,1,1,1,1,1,1,1,1,1,1,1,1,1,1,1,1,1,1,1,1,1,1,1,1,1,1
1,1,1,1,1,37,37,37,1,1,1,1,1,1,1,1,1,1,1,1,1,1,1,1,1,37,1,1,1,1,1,1,1,1,1,1,1,1,1,1,1,1,1,1,1,1,1,1,1,1,1,1,1,1,1,1,1,1,1,1
1,1,1,1,1,1,1,1,1,1,1,1,1,1,37,37,37,37,37,37,37,37,37,1,37,37,1,1,1,1,1,1,37,37,37,37,37,1,1,1,1,1,1,1,1,1,1,1,1,1,1,1,1,1,1,1,1,1,1,1
1,1,1,1,1,1,1,1,1,1,1,1,1,1,1,1,1,1,1,1,1,1,1,1,1,1,1,1,1,1,1,1,1,1,1,1,1,1,1,1,1,1,1,1,1,1,1,1,1,1,1,1,1,1,1,1,1,1,1,1
1,1,1,1,1,1,1,1,1,1,1,1,1,1,1,1,1,1,1,1,1,1,1,1,1,1,1,1,1,1,1,1,1,1,1,1,1,1,1,1,1,1,1,1,1,1,1,1,1,1,1,1,1,1,1,1,1,1,1,1
1,1,1,1,1,1,1,1,1,1,1,1,1,1,1,1,1,1,1,1,1,1,1,1,1,1,1,1,1,1,1,1,1,1,1,1,1,1,1,1,1,1,1,1,1,1,1,1,1,1,1,1,1,1,1,1,1,1,1,1